17 13
11111111111111111
10022020000202201
10121210101010101
12222020020220201
10121012101010101
10220020220220001
10101010101010101
12020002002022001
10121012101210101
10202002020202021
10101010101010101
10222000202020021
11111111111111111

