17 13
11111111111111111
10022q20q00202201
10121210101010101
12222020020220201
10121012101010101
10220020220220q01
10101012101010101
120200020q2022001
101210121012101q1
10202002020202021
10101010101010101
102220q02x2020021
11111111111111111

