17 13
11111111111111111
10000000000200201
10101210101010101
12000020000000201
10121012101010101
10220020020020001
10101010101010101
12020002002002001
10121010101010101
10202002000200001
10101010101010101
10022000200020021
11111111111111111

