29 17
11111111111111111111111111111
10xcqccc2222z2200202000q00001
1x121010101010101010101010101
1c200202020q222020q0002202201
12101210101010101210101010101
102z0202200q00202002000202021
10101210101010101010101010101
12022200002202x02000q00022201
10101210101010101010101010101
10q0020022q2000200x0z0200q001
12101210101210101010101010101
10q0220q00020q00020020000q001
101010101q1010101010101010101
10q00220q020200200200q00220q1
10101010101010101010101010101
1z020q20202220002020200200q01
11111111111111111111111111111
