29 17
11111111111111111111111111111
100222ec2222z22w0202000q0w001
10121010101010101010101010101
1c20w202020q222020q0002202201
12101210101010101210101010101
102z0202200q0w2020w2000202021
10101210101010101010101010101
12022200002202x0200wq00022201
10101210101010101010101010101
10q0w20022q20w0200x0z0200q001
12101210101210101010101010101
10q0220q00020q00020020000q001
101010101q1010101010101010101
10q00220q02020w200200q00220q1
10101010101010101010101010101
1z020q2020222000202020w200q01
11111111111111111111111111111
