29 17
11111111111111111111111111111
1002q0002222z2200202000q00001
10121010101010101010101010101
10200202020q222020q0002202201
10101210101010101210101010101
102z0202200q00202002000202021
10101210101010101010101010101
10022200002200x02000q00000001
10101210101010101010101010101
10q0020000q2000200x0z0200q001
10101210101210101010101010101
10q0000q00020q00020020000q001
101010101q1010101010101010101
10q00220q020200200200q00000q1
10101010101010101010101010101
1z020q20202220002020200200q01
11111111111111111111111111111
