29 27
11111111111111111111111111111
100222xc2222z22w02Q20t0q0w001
1012101Q101010101010101010101
1z2Qt202020q222020q0002202201
12101210101010101210101010101
102z0202200q0w2020w2000202021
10101210101010101010101010101
12022200002202x0200wq0t022201
10101210101010101010101010101
10q0w20022q20w0200x0z0200q001
12101210101210101010101010101
10q0220q00020q00020t2000tq001
101010101q1010101010101010101
10q00220q02020w200200q0022wq1
10101010101010101010101e101e1
1z020q202e222000202020w2QeqQ1
12101210101210101010101010101
10q0220qt0020q00020020t00q001
121012101012101010101t1010101
10q0220q00020q0002002t000q001
12101210101210101010101010101
10q0220q00020q00020020000q001
12101210101210101010101010101
10q0220qt0020q00020020000q001
121012101012101010101010101r1
1Qq0220q0t020q0002002t0QQqQr1
11111111111111111111111111111
